111111
101001
111E01
101001
10C001
1E0P01
111111